2
7 8 2
....*...
***.....
.***....
****....
....**..
..**....
..**....
4 1
5 3
4 8 3
......**
***.****
......**
***.***.
2 3
4 5
2 8
