WWWWWWWWWW
W-------BW
WF--FW---W
W---FW--FW
WWWWW---FW
W--WW---WW
W-FW----FW
W-WWWF---W
W--------W
WWWWWWWWWW
(2,1)
(1,8)