2
7 8 2
....***.
..*....*
.***....
**.**...
.***..**
..**....
**..*..*
7 1
5 6
4 8 3
......**
***.***.
......**
***.***.
2 3
4 5
2 7
