26 15 0 17 43 29 0 45 38 43 22 34 9 48 39 43 6 17 49 12 
47 13 31 16 47 34 43 46 24 10 31 39 48 7 41 49 23 4 22 6 
44 30 43 40 30 23 9 31 35 13 34 1 30 12 42 32 15 7 18 31 
37 13 26 10 25 33 22 26 15 34 36 5 41 46 25 11 45 42 5 2 
0 10 2 46 21 34 36 37 26 17 49 12 43 41 16 29 26 16 9 41 
15 41 33 45 35 3 4 8 24 9 43 30 2 29 7 42 0 25 12 13 
